--GRUPO_N_JKC

/* PARTICIPANTES*/
--RM	      NOME	                                 E-MAIL
--RM92985	Bruno de Oliveira Soares Fonseca	   bruno_chimba@hotmail.com
--RM95764	Gustavo Ribeiro Ferreira	         gustavo.ferreirs@gmail.com
--RM94930	Carollina da Silva França	         carollinafran2@gmail.com
--RM94384	Gabriel Fernandes Silva	               gabriel12258@outlook.com
--RM95793	João Victor Maciel dos Santos	         victormaciel72@hotmail.com


/*  EXCLUSÃO DE TABELAS E CONSTRAINTS */	
DROP TABLE T_JCK_ESTADO	CASCADE CONSTRAINTS;
DROP TABLE T_JCK_TIPO_LAGRADOURO	CASCADE CONSTRAINTS;
DROP TABLE T_JKC_AGENDA	CASCADE CONSTRAINTS;
DROP TABLE T_JKC_ATENDIMENTO	CASCADE CONSTRAINTS;
DROP TABLE T_JKC_AUTOMATIZADA	CASCADE CONSTRAINTS;
DROP TABLE T_JKC_BAIRRO	CASCADE CONSTRAINTS;
DROP TABLE T_JKC_CATEGORIA_MAQUINA	CASCADE CONSTRAINTS;
DROP TABLE T_JKC_CIDADE	CASCADE CONSTRAINTS;
DROP TABLE T_JKC_CLIENTE	CASCADE CONSTRAINTS;
DROP TABLE T_JKC_EMAIL	CASCADE CONSTRAINTS;
DROP TABLE T_JKC_EMPRESA	CASCADE CONSTRAINTS;
DROP TABLE T_JKC_EMPRESA_PROPRIETARIO	CASCADE CONSTRAINTS;
DROP TABLE T_JKC_ENDERECO	CASCADE CONSTRAINTS;
DROP TABLE T_JKC_EQUIPAMENTO_IOT	CASCADE CONSTRAINTS;
DROP TABLE T_JKC_MAQUINA	CASCADE CONSTRAINTS;
DROP TABLE T_JKC_POTENCIAL_CLIENTE	CASCADE CONSTRAINTS;
DROP TABLE T_JKC_PROPRIETARIO	CASCADE CONSTRAINTS;
DROP TABLE T_JKC_RAMO_ATUACAO	CASCADE CONSTRAINTS;
DROP TABLE T_JKC_STATUS_MANUTENCAO	CASCADE CONSTRAINTS;
DROP TABLE T_JKC_TELEFONES	CASCADE CONSTRAINTS;
DROP TABLE T_JKC_VISITA	CASCADE CONSTRAINTS;